###
#@#                              #####################
# #                              #                   #
# ################               # ##########        #######
#                #               # #        #              #
################ #               # #        #        ##### #
               # #               # #        #        #     #
               # #               # #        ########## #####
               # ################# ##########          #
               #                              ##########
               ################################
			   