#########
#GP   FB# 
#W     A#      
#   @   #
#s    r #     
#########
            